{
"map" : [
[0, 0, 0, 0, 0, 0, 0, 0, 0, 0, 0, 0],
[0, 0, 0, 0, 0, 0, 0, 0, 0, 0, 0, 0],
[0, 0, 0, 0, 0, 0, 0, 0, 0, 0, 0, 0],
[0, 0, 0, 0, 0, 0, 0, 0, 0, 0, 0, 0],
[0, 0, 0, 0, 0, 0, 0, 0, 0, 0, 0, 0],
[0, 0, 0, 0, 0, 0, 0, 0, 0, 0, 0, 0],
[1, 1, 1, 1, 1, 1, 1, 1, 1, 1, 1, 1],
[1, 0, 0, 0, 0, 0, 0, 0, 0, 0, 3, 1],
[1, 0, 0, 0, 0, 0, 0, 0, 0, 0, 1, 1],
[1, 0, 0, 0, 1, 0, 0, 0, 2, 2, 1, 1],
[1, 2, 0, 2, 1, 2, 0, 0, 2, 2, 1, 1],
[1, 1, 1, 1, 1, 1, 1, 1, 1, 1, 1, 1]
],
"start_x" : 2,
"start_y" : 10,
"start_direction" : 1
	}