{
"map" : [
[1, 1, 1, 1, 1, 1, 1, 1, 1, 1, 1, 1],
[1, 0, 0, 0, 0, 0, 0, 0, 0, 0, 0, 1],
[1, 0, 0, 0, 0, 0, 0, 0, 0, 0, 3, 1],
[1, 0, 0, 0, 0, 1, 0, 0, 0, 2, 1, 1],
[1, 0, 2, 2, 0, 1, 2, 0, 0, 2, 1, 1],
[1, 1, 1, 1, 1, 1, 1, 1, 1, 1, 1, 1]
],
"start_x" : 1,
"start_y" : 4,
"start_direction" : 1
        }