{
"map" : [
[1, 1, 1, 1, 1, 1, 1, 1],
[1, 3, 0, 0, 0, 0, -0, 1],
[1, 1, 0, 0, 0, 2, 1, 1],
[1, 1, 0, 1, 1, 1, 1, 1],
[1, 1, 1, 1, 1, 1, 1, 1]
],
"start_x" : 6,
"start_y" : 1,
"start_direction" : -1

}